#########################################################################################################################
#E     H P#       # #               # #       #       # #     #   #   #     #         # #   # # #   #         # #     # #
##### ##### ####### ########### ### # # # # ### ### ### # # # ### ### # ### ### ### # # # ### # # ##### ####### # ### # #
#   # C   # #   #     #     #   # # # # # # #   #   #     # #   # # #   #     # #   # # #     # # #   #   #   #     #   #
# ##### ### ### ### # ### ### # # # # ### # # ####### ### ##### # # # # # # # # # # ### # # ### # # ### # # # # ### ### #
#     #         #   #         #   # #   # #       #     #   #         # # # # # # #       # #   #       #   # # #   #   #
### ##### # ####### ##### ### ##### ### # # # # ### ##### ####### ### ##### # # ##### # ####### ##### ### ######### ### #
#   # # # # # #   #     #   #   #   # #   # # # # # #   # #   # #   #     # # # #   # #             #   #     #     #   #
### # # # ### # ##### ######### # ### # ####### # # # ####### # # ### ### ######### ### ### ##### # # # # ##### # #######
# #     #       #   #   #   #   # #   #     #     # # # # #   #   #     # #   #     # # #   # #   # # # # #   # # #     #
# ### # # ### # # # # ### # # # # # # ### # # # ### # # # ### # # ######### ##### # # ##### # ##### ### ### # # ##### ###
#     # # #   #   # #     # # # #   #   # # # # #   #   # # #   # # #   # #       #             #           # #       # #
# ### ##### ##### # # ######### # # ##### # ### ### ### # # ### ### # ### ####### ##### ##### ##### ##### ####### ### # #
#   #   # # #   # #   #     # # # #       # #     # #   # #   # #     # #       # # # # #         #   #     # #   # #   #
# ### ### # ### ### ### ### # # # ### ### ####### # ### # # # # ### # # ##### ##### # # ### # ### ### # ### # # # # ### #
#   # #   # #   # #     # # #   # # #   #       #     #   # #   #   # #     #   # #   # # # # #   # # # #   #   #   # # #
# # # # # ##### # ### # # ######### # ### ####### # ##### ### # ### ### ##### ### ### # # # ####### ### ####### ##### # #
# # #   # #     #     #       #   # # # # #     # #     #     #       # #           #   # #   # #   #   #         #   # #
### # # ### # # # ########### # ### # # # ### # ### ### # ##### # # # # ### ### # ### ### ### # ### ##### # ### # ### # #
#   # #   # # #     #   #     #       #   #   #   # # # # #   # # # #     #   # #   # #             # # # # # # # # # # #
### # ############# # # # # ####### ### # ##### ### # # ### ### # ### ### # # # # ####### ### ### ### # ##### # ### # ###
#   #   # #         # # # # #   #   #   # #   #       # # # #   #   #   # # # # #       # # # #               #       # #
# ##### # ####### # ### ### ### ##### ##### ######### ### # ##### ##### ### # # # # ##### # # ##### ### # ### ### # ### #
#     # #     #   # #   #     # # #   #   #     #     #             #       # # # #   # #   #   #   #   # #     # #   # #
##### ##### # ##### ### ### ### # ##### ### ### # ##### # ### # ### ####### # # ### # # ############### ##### # # ##### #
#   # # # # # #     #   # #     #       # #   #   # # # #   # #   #       # # #   # #       #           # #   #   #     #
### # # # # ##### ### ### ########### # # ####### # # ############# ########### # ##### ### ##### ##### # # ### ##### ###
# #     #       #   #       # # #   # #       #     #   # # # # # # #       #   # #     # # # #   #   #   #   #         #
# ### # ##### # # # # ##### # # # ### # # ### # ### # ### # # # # # # # ##### ### ##### # # # ####### ##### # ##### ### #
#   # #   #   # # #       #         # # # #   #   # # #               # #       #   # # #       #   #   #   # # # #   # #
### ##### # # # ### # # ########### # ########### # # ##### # # ##################### ######### # # ### # ##### # # ### #
#         # # # #   # # # # # #             #   # # #       # #   #   # #           # # #       # # #     #   #   # # # #
# ### # # ### ##### # # # # # # ##### ##### ### ##### ####### ### # # # # ### ##### # # # ######### ### ### ### ##### ###
# #   # # #       # # #   #   #     #   # #   # #     # # # # #   # #       #     #     # # # #                         #
# # ########### ##### ##### ##### ####### ### # ### ### # # ### # ####### ########### # ### # # ######### ### ### # # # #
# # #           # #         #       #       # #             # # # # #         # #     #   #     #       # #   #   # # # #
# ### # # ##### # # ### # ### ##### ### ### ### # ######### # ##### ##### # ### # ### # ####### # ### ############# ### #
#     # #   #     #   # # #     # # #   #     # #   #     #               # # # # #   #     #   #   # #     #     #   # #
### ### ##### ### # # # # ####### # # ##### # # ##### ####### ### ######### # # # # # ######### ### ### ### ##### # # ###
# #   # # # # #     # # #   #           #   # #   #     #       #   # # #   #   # # #         #       # #   #     # #   #
# # ##### # # ### ######### ####### ### ####### ##### # # ####### ### # ##### ############# ### ##### ##### # # # ### ###
#       # #   #     #     #   #       #   #     # # # #     #       #             # # #   #     #   #       # # #       #
# ### # # ### ##### ### # # # # # ### ### # ### # # # ### # ##### ### # # ##### ### # # # # ##### ######### ####### #####
# # # # #         #   # #   # # # #   # # #   #   #     # #   #       # # # # #   # #   # #     #   #       #     # # # #
# # ####### ######### ### ### # # ### # # ####### # ############# ### ##### # # ### # ### ##### # ### ##### ### # # # # #
# # #             # # # #   # # # #     # # #   # # #   # #       #     #       # #   #       #   #       #     # # # # #
### # ### # # # ### ### ################# # ### # ##### # # ### ### # ### # # # # # ##### # ### ########### # # ### # # #
#     #   # # #   # # # #             #   # #   # #   #     #   #   # #   # # # #     # # #               # # # #     # #
# ### ### # ### # # # # # # # ### # # # ### # ### ### ### ##### ### ####### ########### ######### ### # ##### ##### ### #
#   # # # # #   # # #   # # # # # # #       #     # #   #     #   #       #   #   # # #   #     # #   # # #   #     # # #
##### # ##### ### # # # ### ### # ### ########### # # ################# ### # # ### # ### # # ### ### ### ### # # # # # #
#   # #     #   #   # # # # # # #   # #   # # # #         # # #     # #   # # #   #         #   # #   #   #   # # #     #
### # # # ##### # # ### # ### # ######### # # # # ##### ### # ##### # ### ### # # # # ######### # ### # ### # ### # ### #
# #     #   #   # # #     #     #                   # # #   #           #   #   # # # # #       # # #     # #   # # #   #
# ### ##### ####### # # ### # ######### ##### ### # # ### ##### ##### ##### ##### ### # ####### ### ########### ####### #
#     #     #   # #   #   # #       #       # #   # #     #         #   #   #             #       # #   # #   # # #     #
# ######### ### # # ### ########### # ############# # # # ##### ##### ##### ##### ######### # ### # ### # ### # # # # # #
# # #     #     #   #         # #   # #   # # #       # # # #       #         #     #       #   #   # #   # #     # # # #
### ### # ### # ##### # # # ### # # ##### # # # ### ### ### ### # ### ### # ### ### ####### ####### # # ### # # ### # # #
#       #     #   #   # # # #     #             #   #       #   # #     # #   # #       #   #           #     #   # # # #
######################################################################################################################### 
