######################
#P #           #  # M#
#  #  #  #  ####  #  #
#     #  #           #
#  ####  #  #  #######
#     #  #  #        #
####  ##########  ####
#        #  #        #
#######  #  ####  ####
#           #  #     #
#  ####  ####  ####  #
#  #        #       H#
####  ####  ####  # p#
#K       #  #     #  #
######################